521335102155425050432321111550241334140203004324450430150-
354034255322535421423543424043201212123452010545104430200-
352401025524552133052441313340352523523314513343451322504-
0000000000000A8888888888888888888888888888888888888888888-
0000000000000E7777777777777777777777777777777777777777777-
0000000000000E7777777777777777777777777777777777777777777-
0000000000000E7777777777777777777777777777777777777777777-
0000000000A8877777777777777777777777777777777777777777777-
0000000000E7777777777777777777777777777777777777777777777-
0000000000E7777777777777777777777777777777777777777777777-
0000000000E7777777777777777777777777777777777777777777777-
0000000000E7777777777777777777777777777777777777777777777-
0000000000DBB77777777777777777777777777777777777777777777-
0000000000000E7777777777777777777777777777777777777777777-
0000000000000E7777777777777777777777777777777777777777777-
0000000000000E7777777777777777777777777777777777777777777-
0000000000000DBBBBBBBBBBBBBBBBBBBBBBBBBBBBBBBBBBBBBBBBBBB-
452514012245313540420255242225121354004540303451220410205-
015455521251534440035014250234250102524542425330250214101-
412104304354112034524220343450555400502405541554432002252